Race,Gender,0-20,21-40,41-60,61+,Total
White,Male,895,411,673,472,2451
White,Female,1036,623,579,576,2814
Black,Male,68,45,36,52,201
Black,Female,92,55,39,18,204
Asian,Male,521,110,58,44,733
Asian,Female,496,239,30,55,820
Indian,Male,266,150,74,42,532
Indian,Female,341,448,88,43,920
Others,Male,191,185,73,6,455
Others,Female,361,267,15,5,648
Total,,4267,2533,1665,1313,9778
