Age Group,Gender,White,Black,Asian,Indian,Others,Total
0-20,Female,1036,92,496,341,361,2326
0-20,Male,895,68,521,266,191,1941
21-40,Female,623,55,239,448,267,1632
21-40,Male,411,45,110,150,185,901
41-60,Female,579,39,30,88,15,751
41-60,Male,673,36,58,74,73,914
61-80,Female,405,10,19,28,3,465
61-80,Male,388,45,28,35,6,502
81-116,Female,171,8,36,15,2,232
81-116,Male,84,7,16,7,0,114
